
19,10
1,1,1,1,1,1,1,1,1,1,1,1,1,1,1,1,1,1,1
1,2,0,0,0,1,0,0,0,0,1,0,0,1,0,0,0,1,1
1,1,1,1,0,1,0,1,1,0,1,0,1,0,1,0,1,0,1
1,0,0,1,0,0,0,1,0,0,0,0,0,0,1,0,0,0,1
1,0,1,1,1,1,0,1,1,1,0,1,1,1,0,1,1,0,1
1,0,0,0,0,1,0,0,0,1,0,0,0,1,0,0,1,0,1
1,1,1,1,0,1,1,1,0,1,1,1,0,1,1,1,0,1,1
1,0,0,1,0,0,0,1,0,0,0,1,0,0,0,1,0,0,1
1,0,1,1,1,1,0,1,1,1,0,1,1,1,0,0,0,3,1
1,1,1,1,1,1,1,1,1,1,1,1,1,1,1,1,1,1,1


20,10
1,1,1,1,1,1,1,1,1,1,1,1,1,1,1,1,1,1,1,1
1,2,0,0,0,1,0,0,0,0,1,0,0,1,0,0,0,1,0,1
1,1,1,1,0,1,0,1,1,0,1,0,1,1,0,1,0,1,0,1
1,0,0,1,0,0,0,1,0,0,0,0,0,0,0,1,0,0,0,1
1,0,1,1,1,1,0,1,1,1,0,1,1,1,0,1,1,1,0,1
1,0,0,0,0,1,0,0,0,1,0,0,0,1,0,0,0,1,0,1
1,1,1,1,0,1,1,1,0,1,1,1,0,1,1,1,0,1,1,1
1,0,0,1,0,0,0,1,0,0,0,1,0,0,0,1,0,0,3,1
1,0,1,1,1,1,0,1,1,1,0,1,1,1,0,1,1,1,0,1
1,1,1,1,1,1,1,1,1,1,1,1,1,1,1,1,1,1,1,1